XXXXXXXXXXXXXXXX
X...XX...XX..X.X
X............X.X
X........X...X.X
X.X...X..X...X.X
X.X...X..X...X.X
X.X...X..X.....X
X.X...X..X.....X
X..............X
XXX..XXXX.XXXX.X
X..............X
XXXXXXXXXXXXXXXX
